-lv1
00000000
10000000
00000000
00010000
10000000
00000000
00000000
00000000
#end
-lv2
00000000
00000000
00000000
01001000
00000010
00010000
00000000
00000000
#end
-lv3
00000000
00010000
00000001
01001000
00000010
00000000
00000000
00000000
#end
-lv4
10000000
00000000
00001000
00000000
10000000
00001000
00000000
00000000
#end
-lv5
00000000
00000000
00000000
00110001
00000000
00000100
00010000
00000000
#end